%%%%%%%%%%%%%############XXXXXXXXXXXXXXXXXXXX
% P       %%          g #   WWWWW    W$ WW  X
%%%%%%   %%    #      # #s              WW  X
#    #       ###      # #s  s WWWWWWX   W   X
#$  i#  @    # G   M  # $   WWWWW WXXX      X
### ## #### XXXXXXXX ####XXXXXXXXXXXXXXXXXXRX
#    # s #    XXX  X  @ #X  WWWWWWWWWWWWWX  %
#.@  #  $#M   X g  X  # #X             @WX  %
### ## #### XXXXXX X#####X  WWWWWWWWWWWWWX  %
# ^^ #  ss   ###    @ # #X  W$              %
#^^^^^       # @      # #X  WWWWWWWWWWWWWX  %
#^^^^^^ @    ###      # #X       $W$        %
#,.^^^^^###       @   # #X  WWWWWWWWWWWWWX  %
%%%%% WWWWWWWWWWWWWWWWW %X  W@          WX  %
%                     @ %X  WWWWWW WWWWWWX  %
%  %% WWWW WWWWWWWWWWWWW%   l               %
%  %i %%    %%%i  %%%% %%%%%%%%%%%% %%%%%%%%%
%  %  %$r   $%$      %              %       %
%     %%%vv%%%%%  %% s %%%%%%%%%%%     %%%  %
%%%%%%%%%%%%%%%%%%%%%%%%%%%%%%%%%%%%%%%%%%%%%